12111111111111111111111111111111111111111111111121
20000000000000000000000000000000000000000000000002
20000000000000000000000000000000000000000000000001
20000000000000000000000000000000000000000000000001
20000000000000000000000000000000000000000000000001
10000000000000000000000000000000000000000000000001
10000000000000000000000000000000000000000000000001
10000000000000000000000000000000000000000000000001
10000000000000000222222222000000000000000000000001
10000000000000000220000022000000000000000000000001
10000000000000000220000022000000000000000000000001
1000000000000000000000000000000000000000000000001
10000000000000000000000000000000000000000000000001
10000000000000000000000000000000000000000000000001
10000000000000000000000000000000000000000000000001
10000000000000000000000000000000000000000000000001
10000000000000000000000000000000000000000000000001
10000000000000000000000000000000000000000000000001
20000000000000000000000000000000000000000000000002
12111111111111111111111111111111111111111111111121
