121212121212111111111111111111111111111111111111212
200000000000000000000000000000000000000000000000001
100000000000000000000000000000000000000000000000002
200000000000000000000000000000000000000000000000001
100000000000000000000000000000000000000000000000002
200000000000000000000000000000000000000000000000001
200000000000000000000000000000000000000000000000001
200000000000000000000000000000000000000000000000001
200000000000000000000000000000000000000000000000001
200000000000000000000000000000000000000000000000001
200000000000000000000000000000000000000000000000001
200000000000000000000000000000000000000000000000001
200000000000000000000000000000000000000000000000001
200000000000000000000000000000000000000000000000001
200000000000000000000000000000000000000000000000001
200000000000000000000000000000000000000000000000001
200000000000000000000000000000000000000000000000001
200000000000000000000000000000000000000000000000001
200000000000000000000000000000000000000000000000001
121212121212111111111111111111111111111111111111212
