111111110
000000000
000000000
000111000
000000000
111000000
000000000
00000*000
111000000
000000000
